42 42
100 100
17 17 17 17 17 17 17 17 17 17 17 17 17 17 17 17 17 17 17 17 17 17 17 17 17 17 17 17 17 17 17 17 17 17 17 17 17 17 17 17 17 17 
17 8 8 8 8 8 8 8 8 8 8 8 8 8 8 8 8 8 8 8 8 8 8 8 8 8 8 8 8 8 8 8 8 8 8 8 8 8 8 8 8 17 
17 8 10 10 10 10 10 10 10 10 10 10 10 10 10 10 10 10 10 8 8 8 8 10 10 10 10 10 10 10 10 10 10 10 10 10 10 10 10 10 8 17 
17 8 10 10 10 10 10 10 10 10 10 10 10 10 10 10 10 10 10 8 17 17 8 10 10 10 10 10 10 10 10 10 10 10 10 10 10 10 10 10 8 17 
17 8 10 10 10 10 10 10 10 10 10 10 10 10 10 10 10 10 10 8 17 17 8 10 10 10 10 10 10 10 10 10 10 10 10 10 10 10 10 10 8 17 
17 8 10 10 10 10 10 10 10 10 10 10 10 10 10 10 10 10 10 8 17 17 8 10 10 10 10 10 10 10 10 10 10 10 10 10 10 10 10 10 8 17 
17 8 10 10 10 10 10 10 10 10 10 10 10 10 10 10 10 10 10 8 17 17 8 10 10 10 10 10 10 10 10 10 10 10 10 10 10 10 10 10 8 17 
17 8 10 10 10 10 10 10 10 10 10 10 10 10 10 10 10 10 10 8 17 17 8 10 10 10 10 10 10 10 10 10 10 10 10 10 10 10 10 10 8 17 
17 8 10 10 10 10 10 10 10 10 10 10 10 10 10 10 10 10 10 8 17 17 8 10 10 10 10 10 10 10 10 10 10 10 10 10 10 10 10 10 8 17 
17 8 10 10 10 10 10 10 10 10 10 10 10 10 10 10 10 10 10 8 17 17 8 10 10 10 10 10 10 10 10 10 10 10 10 10 10 10 10 10 8 17 
17 8 10 10 10 10 10 10 10 10 10 10 10 10 10 10 10 10 10 8 17 17 8 10 10 10 10 10 10 10 10 10 10 10 10 10 10 10 10 10 8 17 
17 8 10 10 10 10 10 10 10 10 10 10 10 10 10 10 10 10 10 8 17 17 8 10 10 10 10 10 10 10 10 10 10 10 10 10 10 10 10 10 8 17 
17 8 10 10 10 10 10 10 10 10 10 10 10 10 10 10 10 10 10 8 17 17 8 10 10 10 10 10 10 10 10 10 10 10 10 10 10 10 10 10 8 17 
17 8 10 10 10 10 10 10 10 10 10 10 10 10 10 10 10 10 10 8 17 17 8 10 10 10 10 10 10 10 10 10 10 10 10 10 10 10 10 10 8 17 
17 8 10 10 10 10 10 10 10 10 10 10 10 10 10 10 10 10 10 8 17 17 8 10 10 10 10 10 10 10 10 10 10 10 10 10 10 10 10 10 8 17 
17 8 10 10 10 10 10 10 10 10 10 10 10 10 10 10 10 10 10 8 17 17 8 10 10 10 10 10 10 10 10 10 10 10 10 10 10 10 10 10 8 17 
17 8 10 10 10 10 10 10 10 10 10 10 10 10 10 10 10 10 10 8 17 17 8 10 10 10 10 10 10 10 10 10 10 10 10 10 10 10 10 10 8 17 
17 8 10 10 10 10 10 10 10 10 10 10 10 10 10 10 10 10 10 8 17 17 8 10 10 10 10 10 10 10 10 10 10 10 10 10 10 10 10 10 8 17 
17 8 10 10 10 10 10 10 10 10 10 10 10 10 10 10 10 10 10 8 17 17 8 10 10 10 10 10 10 10 10 10 10 10 10 10 10 10 10 10 8 17 
17 8 8 8 8 8 8 8 8 8 8 8 8 8 8 8 8 8 8 8 17 17 8 8 8 8 8 8 8 8 8 8 8 8 8 8 8 8 8 8 8 17 
17 8 8 17 17 17 17 17 17 17 17 17 17 17 17 17 17 17 17 17 17 17 17 17 17 17 17 17 17 17 17 17 17 17 17 17 17 17 17 8 8 17 
17 8 8 17 17 17 17 17 17 17 17 17 17 17 17 17 17 17 17 17 17 17 17 17 17 17 17 17 17 17 17 17 17 17 17 17 17 17 17 8 8 17 
17 8 8 8 8 8 8 8 8 8 8 8 8 8 8 8 8 8 8 8 17 5 8 8 8 8 8 8 8 8 8 8 8 8 8 8 8 8 8 8 8 17 
17 8 10 10 10 10 10 10 10 10 10 10 10 10 10 10 10 10 10 8 17 5 8 10 10 10 10 10 10 10 10 10 10 10 10 10 10 10 10 10 8 17 
17 8 10 10 10 10 10 10 10 10 10 10 10 10 10 10 10 10 10 8 17 17 8 10 10 10 10 10 10 10 10 10 10 10 10 10 10 10 10 10 8 17 
17 8 10 10 10 10 10 10 10 10 10 10 10 10 10 10 10 10 10 8 17 17 8 10 10 10 10 10 10 10 10 10 10 10 10 10 10 10 10 10 8 17 
17 8 10 10 10 10 10 10 10 10 10 10 10 10 10 10 10 10 10 8 17 17 8 10 10 10 10 10 10 10 10 10 10 10 10 10 10 10 10 10 8 17 
17 8 10 10 10 10 10 10 10 10 10 10 10 10 10 10 10 10 10 8 17 17 8 10 10 10 10 10 10 10 10 10 10 10 10 10 10 10 10 10 8 17 
17 8 10 10 10 10 10 10 10 10 10 10 10 10 10 10 10 10 10 8 17 17 8 10 10 10 10 10 10 10 10 10 10 10 10 10 10 10 10 10 8 17 
17 8 10 10 10 10 10 10 10 10 10 10 10 10 10 10 10 10 10 8 17 17 8 10 10 10 10 10 10 10 10 10 10 10 10 10 10 10 10 10 8 17 
17 8 10 10 10 10 10 10 10 10 10 10 10 10 10 10 10 10 10 8 17 17 8 10 10 10 10 10 10 10 10 10 10 10 10 10 10 10 10 10 8 17 
17 8 10 10 10 10 10 10 10 10 10 10 10 10 10 10 10 10 10 8 17 17 8 10 10 10 10 10 10 10 10 10 10 10 10 10 10 10 10 10 8 17 
17 8 10 10 10 10 10 10 10 10 10 10 10 10 10 10 10 10 10 8 17 17 8 10 10 10 10 10 10 10 10 10 10 10 10 10 10 10 10 10 8 17 
17 8 10 10 10 10 10 10 10 10 10 10 10 10 10 10 10 10 10 8 17 17 8 10 10 10 10 10 10 10 10 10 10 10 10 10 10 10 10 10 8 17 
17 8 10 10 10 10 10 10 10 10 10 10 10 10 10 10 10 10 10 8 17 17 8 10 10 10 10 10 10 10 10 10 10 10 10 10 10 10 10 10 8 17 
17 8 10 10 10 10 10 10 10 10 10 10 10 10 10 10 10 10 10 8 17 17 8 10 10 10 10 10 10 10 10 10 10 10 10 10 10 10 10 10 8 17 
17 8 10 10 10 10 10 10 10 10 10 10 10 10 10 10 10 10 10 8 17 17 8 10 10 10 10 10 10 10 10 10 10 10 10 10 10 10 10 10 8 17 
17 8 10 10 10 10 10 10 10 10 10 10 10 10 10 10 10 10 10 8 17 17 8 10 10 10 10 10 10 10 10 10 10 10 10 10 10 10 10 10 8 17 
17 8 10 10 10 10 10 10 10 10 10 10 10 10 10 10 10 10 10 8 17 17 8 10 10 10 10 10 10 10 10 10 10 10 10 10 10 10 10 10 8 17 
17 8 10 10 10 10 10 10 10 10 10 10 10 10 10 10 10 10 10 8 8 8 8 10 10 10 10 10 10 10 10 10 10 10 10 10 10 10 10 10 8 17 
17 8 8 8 8 8 8 8 8 8 8 8 8 8 8 8 8 8 8 8 8 8 8 8 8 8 8 8 8 8 8 8 8 8 8 8 8 8 8 8 8 17 
17 17 17 17 17 17 17 17 17 17 17 17 17 17 17 17 17 17 17 17 17 17 17 17 17 17 17 17 17 17 17 17 17 17 17 17 17 17 17 17 17 17
