42 42
100 100
16 16 16 16 16 16 16 16 16 16 16 16 16 16 16 16 16 16 16 16 16 16 16 16 16 16 16 16 16 16 16 16 16 16 16 16 16 16 16 16 16 16 
16 0 0 0 0 0 0 0 0 0 0 0 0 0 0 0 0 0 0 0 16 16 0 0 0 0 0 0 0 0 0 0 0 0 0 0 0 0 0 0 0 16 
16 0 1 1 1 1 1 1 1 1 0 1 1 1 1 1 1 1 1 0 16 16 0 1 1 1 1 1 1 1 1 0 1 1 1 1 1 1 1 1 0 16 
16 0 1 1 1 1 1 1 1 1 0 1 1 1 1 1 1 1 1 0 16 16 0 1 1 1 1 1 1 1 1 0 1 1 1 1 1 1 1 1 0 16 
16 0 1 1 1 1 1 1 1 1 0 1 1 1 1 1 1 1 1 0 16 16 0 1 1 1 1 1 1 1 1 0 1 1 1 1 1 1 1 1 0 16 
16 0 1 1 1 1 1 1 1 1 0 1 1 1 1 1 1 1 1 0 16 16 0 1 1 1 1 1 1 1 1 0 1 1 1 1 1 1 1 1 0 16 
16 0 1 1 1 1 0 0 0 0 0 0 0 0 0 1 1 1 1 0 16 16 0 1 1 1 1 0 0 0 0 0 0 0 0 0 1 1 1 1 0 16 
16 0 1 1 1 1 0 16 16 16 16 16 16 16 0 1 1 1 1 0 16 16 0 1 1 1 1 0 16 16 16 16 16 16 16 0 1 1 1 1 0 16 
16 0 1 1 1 1 0 16 0 0 0 0 0 16 0 1 1 1 1 0 16 16 0 1 1 1 1 0 16 0 0 0 0 0 16 0 1 1 1 1 0 16 
16 0 1 1 1 1 0 16 0 1 1 1 0 16 0 1 1 1 1 0 16 16 0 1 1 1 1 0 16 0 1 1 1 0 16 0 1 1 1 1 0 16 
16 0 0 0 0 0 0 16 0 1 1 1 0 16 0 0 0 0 0 0 16 16 0 0 0 0 0 0 16 0 1 1 1 0 16 0 0 0 0 0 0 16 
16 0 1 1 1 1 0 16 0 1 1 1 0 16 0 1 1 1 1 0 16 16 0 1 1 1 1 0 16 0 1 1 1 0 16 0 1 1 1 1 0 16
16 0 1 1 1 1 0 16 0 0 0 0 0 16 0 1 1 1 1 0 16 16 0 1 1 1 1 0 16 0 0 0 0 0 16 0 1 1 1 1 0 16
16 0 1 1 1 1 0 16 16 16 0 16 16 16 0 1 1 1 1 0 16 16 0 1 1 1 1 0 16 16 16 0 16 16 16 0 1 1 1 1 0 16 
16 0 1 1 1 1 0 0 0 0 0 0 0 0 0 1 1 1 1 0 16 16 0 1 1 1 1 0 0 0 0 0 0 0 0 0 1 1 1 1 0 16
16 0 1 1 1 1 1 1 1 1 0 1 1 1 1 1 1 1 1 0 16 16 0 1 1 1 1 1 1 1 1 0 1 1 1 1 1 1 1 1 0 16
16 0 1 1 1 1 1 1 1 1 0 1 1 1 1 1 1 1 1 0 16 16 0 1 1 1 1 1 1 1 1 0 1 1 1 1 1 1 1 1 0 16
16 0 1 1 1 1 1 1 1 1 0 1 1 1 1 1 1 1 1 0 16 16 0 1 1 1 1 1 1 1 1 0 1 1 1 1 1 1 1 1 0 16
16 0 1 1 1 1 1 1 1 1 0 1 1 1 1 1 1 1 1 0 0 0 0 1 1 1 1 1 1 1 1 0 1 1 1 1 1 1 1 1 0 16
16 0 0 0 0 0 0 0 0 0 0 0 0 0 0 0 0 0 0 0 0 0 0 0 0 0 0 0 0 0 0 0 0 0 0 0 0 0 0 0 0 16 
16 16 16 16 16 16 16 16 16 16 16 16 16 16 16 16 16 16 0 0 0 0 0 0 16 16 16 16 16 16 16 16 16 16 16 16 16 16 16 16 16 16
16 16 16 16 16 16 16 16 16 16 16 16 16 16 16 16 16 16 0 0 0 0 0 0 16 16 16 16 16 16 16 16 16 16 16 16 16 16 16 16 16 16 
16 0 0 0 0 0 0 0 0 0 0 0 0 0 0 0 0 0 0 0 0 0 0 0 0 0 0 0 0 0 0 0 0 0 0 0 0 0 0 0 0 16 
16 0 1 1 1 1 1 1 1 1 0 1 1 1 1 1 1 1 1 0 0 0 0 1 1 1 1 1 1 1 1 0 1 1 1 1 1 1 1 1 0 16 
16 0 1 1 1 1 1 1 1 1 0 1 1 1 1 1 1 1 1 0 16 16 0 1 1 1 1 1 1 1 1 0 1 1 1 1 1 1 1 1 0 16 
16 0 1 1 1 1 1 1 1 1 0 1 1 1 1 1 1 1 1 0 16 16 0 1 1 1 1 1 1 1 1 0 1 1 1 1 1 1 1 1 0 16 
16 0 1 1 1 1 1 1 1 1 0 1 1 1 1 1 1 1 1 0 16 16 0 1 1 1 1 1 1 1 1 0 1 1 1 1 1 1 1 1 0 16 
16 0 1 1 1 1 0 0 0 0 0 0 0 0 0 1 1 1 1 0 16 16 0 1 1 1 1 0 0 0 0 0 0 0 0 0 1 1 1 1 0 16 
16 0 1 1 1 1 0 16 16 16 16 16 16 16 0 1 1 1 1 0 16 16 0 1 1 1 1 0 16 16 16 16 16 16 16 0 1 1 1 1 0 16 
16 0 1 1 1 1 0 16 0 0 0 0 0 16 0 1 1 1 1 0 16 16 0 1 1 1 1 0 16 0 0 0 0 0 16 0 1 1 1 1 0 16 
16 0 1 1 1 1 0 16 0 1 1 1 0 16 0 1 1 1 1 0 16 16 0 1 1 1 1 0 16 0 1 1 1 0 16 0 1 1 1 1 0 16 
16 0 0 0 0 0 0 16 0 1 1 1 0 16 0 0 0 0 0 0 16 16 0 0 0 0 0 0 16 0 1 1 1 0 16 0 0 0 0 0 0 16 
16 0 1 1 1 1 0 16 0 1 1 1 0 16 0 1 1 1 1 0 16 16 0 1 1 1 1 0 16 0 1 1 1 0 16 0 1 1 1 1 0 16
16 0 1 1 1 1 0 16 0 0 0 0 0 16 0 1 1 1 1 0 16 16 0 1 1 1 1 0 16 0 0 0 0 0 16 0 1 1 1 1 0 16
16 0 1 1 1 1 0 16 16 16 0 16 16 16 0 1 1 1 1 0 16 16 0 1 1 1 1 0 16 16 16 0 16 16 16 0 1 1 1 1 0 16 
16 0 1 1 1 1 0 0 0 0 0 0 0 0 0 1 1 1 1 0 16 16 0 1 1 1 1 0 0 0 0 0 0 0 0 0 1 1 1 1 0 16
16 0 1 1 1 1 1 1 1 1 0 1 1 1 1 1 1 1 1 0 16 16 0 1 1 1 1 1 1 1 1 0 1 1 1 1 1 1 1 1 0 16
16 0 1 1 1 1 1 1 1 1 0 1 1 1 1 1 1 1 1 0 16 16 0 1 1 1 1 1 1 1 1 0 1 1 1 1 1 1 1 1 0 16
16 0 1 1 1 1 1 1 1 1 0 1 1 1 1 1 1 1 1 0 16 16 0 1 1 1 1 1 1 1 1 0 1 1 1 1 1 1 1 1 0 16
16 0 1 1 1 1 1 1 1 1 0 1 1 1 1 1 1 1 1 0 16 16 0 1 1 1 1 1 1 1 1 0 1 1 1 1 1 1 1 1 0 16
16 0 0 0 0 0 0 0 0 0 0 0 0 0 0 0 0 0 0 0 16 16 0 0 0 0 0 0 0 0 0 0 0 0 0 0 0 0 0 0 0 16 
16 16 16 16 16 16 16 16 16 16 16 16 16 16 16 16 16 16 16 16 16 16 16 16 16 16 16 16 16 16 5 5 5 16 16 16 16 16 16 16 16 16
