100 100
100 3000
19 19 19 19 19 19 19 19 19 19 19 19 19 19 19 19 19 19 19 19 19 19 19 19 19 19 19 19 19 19 19 19 19 19 19 19 19 19 19 19 19 19 19 19 19 19 19 19 19 19 19 19 19 19 19 19 19 19 19 19 19 19 19 19 19 19 19 19 19 19 19 19 19 19 19 19 19 19 19 19 19 19 19 19 19 19 19 19 19 19 19 19 19 19 19 19 19 19 19 19  
19 4 4 4 4 4 4 4 4 4 4 4 4 4 4 4 4 4 4 4 4 4 4 4 4 4 4 4 4 4 4 4 4 4 4 4 4 4 4 4 4 4 4 4 4 4 4 4 4 4 4 4 4 4 4 4 4 4 4 4 4 4 4 4 4 4 4 4 4 4 4 4 4 4 4 4 4 4 4 4 4 4 4 4 4 4 4 4 4 4 4 4 4 4 4 4 4 4 4 19  
19 4 11 11 11 11 11 11 11 11 11 11 11 11 11 11 11 11 11 11 11 11 11 11 11 11 11 11 11 11 11 11 11 11 11 11 11 11 11 11 11 11 11 11 11 11 11 11 11 11 11 11 11 11 11 11 11 11 11 11 11 11 11 11 11 11 11 11 11 11 11 11 11 11 11 11 11 11 11 11 11 11 11 11 11 11 11 11 11 11 11 11 11 11 11 11 11 11 11 19  
19 4 11 11 11 11 11 11 11 11 11 11 11 11 11 11 11 11 11 11 11 11 11 11 11 11 11 11 11 11 11 11 11 11 11 11 11 11 11 11 11 11 11 11 11 11 11 11 11 11 11 11 11 11 11 11 11 11 11 11 11 11 11 11 11 11 11 11 11 11 11 11 11 11 11 11 11 11 11 11 11 11 11 11 11 11 11 11 11 11 11 11 11 11 11 11 11 11 11 19  
19 4 11 11 11 11 11 11 11 11 11 11 11 11 11 11 11 11 11 11 11 11 11 11 11 11 11 11 11 11 11 11 11 11 11 11 11 11 11 11 11 11 11 11 11 11 11 11 11 11 11 11 11 11 11 11 11 11 11 11 11 11 11 11 11 11 11 11 11 11 11 11 11 11 11 11 11 11 11 11 11 11 11 11 11 11 11 11 11 11 11 11 11 11 11 11 11 11 11 19  
19 4 11 11 11 11 11 11 11 11 11 11 11 11 11 11 11 11 11 11 11 11 11 11 11 11 11 11 11 11 11 11 11 11 11 11 11 11 11 11 11 11 11 11 11 11 11 11 11 11 11 11 11 11 11 11 11 11 11 11 11 11 11 11 11 11 11 11 11 11 11 11 11 11 11 11 11 11 11 11 11 11 11 11 11 11 11 11 11 11 11 11 11 11 11 11 11 11 11 19  
19 4 11 11 11 11 11 11 11 11 11 11 11 11 11 11 11 11 11 11 4 4 4 4 4 4 4 4 4 4 4 4 4 4 4 4 4 4 4 4 4 4 4 4 4 11 11 11 11 11 11 11 11 11 11 4 4 4 4 11 11 4 4 4 4 4 4 4 4 4 4 4 4 4 11 11 4 4 4 4 11 11 11 11 11 11 11 11 11 11 11 11 11 11 11 11 11 11 11 19  
19 4 11 11 11 11 11 11 11 11 11 11 11 11 11 11 11 11 11 11 4 19 19 19 19 19 19 19 19 19 19 19 19 19 19 19 19 19 19 19 19 19 19 19 4 11 11 11 11 11 11 11 11 11 11 4 19 19 4 11 11 4 19 19 19 19 19 19 19 19 19 19 19 4 11 11 4 19 19 4 11 11 11 11 11 11 11 11 11 11 11 11 11 11 11 11 11 11 11 19  
19 4 11 11 11 11 11 11 11 11 11 11 11 11 11 11 11 11 11 11 4 19 19 19 19 19 19 19 19 19 19 19 19 19 19 19 19 19 19 19 19 19 19 19 4 11 11 11 11 11 11 11 11 11 11 4 19 19 4 11 11 4 19 4 4 4 4 4 4 4 4 4 19 4 11 11 4 19 19 4 11 11 11 11 11 11 11 11 11 11 11 11 11 11 11 11 11 11 11 19  
19 4 11 11 11 11 11 11 11 11 11 11 11 11 11 11 11 11 11 11 4 19 19 4 4 4 4 4 4 4 4 4 4 4 4 4 4 4 4 4 4 4 19 19 4 11 11 11 11 11 11 11 11 11 11 4 19 19 4 11 11 4 19 4 11 11 11 11 11 11 11 4 19 4 11 11 4 19 19 4 11 11 11 11 11 11 11 11 11 11 11 11 11 11 11 11 11 11 11 19  
19 4 11 11 11 11 11 11 11 11 11 11 11 11 11 11 11 11 11 11 4 19 19 4 11 11 11 11 11 11 11 11 11 11 11 11 11 11 11 11 11 4 19 19 4 11 11 11 11 11 11 11 11 11 11 4 19 19 4 11 11 4 19 4 11 11 11 11 11 11 11 4 19 4 11 11 4 19 19 4 11 11 11 11 11 11 11 11 11 11 11 11 11 11 11 11 11 11 11 19  
19 4 11 11 11 11 11 11 11 11 11 11 11 11 11 11 11 11 11 11 4 19 19 4 11 11 11 11 11 11 11 11 11 11 11 11 11 11 11 11 11 4 19 19 4 11 11 11 11 11 11 11 11 11 11 4 19 19 4 11 11 4 19 4 11 11 11 11 11 11 11 4 19 4 11 11 4 19 19 4 11 11 11 11 11 11 11 11 11 11 11 11 11 11 11 11 11 11 11 19  
19 4 11 11 11 11 11 11 11 11 11 11 11 11 11 11 11 11 11 11 4 19 19 4 11 11 4 4 4 11 11 11 11 11 11 11 4 4 4 11 11 4 19 19 4 11 11 11 11 11 11 11 11 11 11 4 19 19 4 11 11 4 19 4 11 11 11 11 11 11 11 4 19 4 11 11 4 19 19 4 11 11 11 11 11 11 11 11 11 11 11 11 11 11 11 11 11 11 11 19  
19 4 11 11 11 11 11 11 11 11 11 11 11 11 11 11 11 11 11 11 4 19 19 4 11 11 4 19 4 11 11 11 11 11 11 11 4 19 4 11 11 4 19 19 4 11 11 11 11 11 11 11 11 11 11 4 19 19 4 11 11 4 19 4 11 11 11 11 11 11 11 4 19 4 11 11 4 19 19 4 11 11 11 11 11 11 11 11 11 11 11 11 11 11 11 11 11 11 11 19  
19 4 11 11 11 11 11 11 11 11 11 11 11 11 11 11 11 11 11 11 4 19 19 4 11 11 4 19 4 11 11 11 11 11 11 11 4 19 4 11 11 4 19 19 4 11 11 11 11 11 11 11 11 11 11 4 19 19 4 11 11 4 19 4 11 11 11 11 11 11 11 4 19 4 11 11 4 19 19 4 11 11 11 11 11 11 11 11 11 11 11 11 11 11 11 11 11 11 11 19  
19 4 11 11 11 11 11 11 11 11 11 11 11 11 11 11 11 11 11 11 4 19 19 4 11 11 4 19 4 11 11 11 11 11 11 11 4 19 4 11 11 4 19 19 4 11 11 11 11 11 11 11 11 11 11 4 19 19 4 11 11 4 19 4 11 11 11 11 11 11 11 4 19 4 11 11 4 19 19 4 11 11 11 11 11 11 11 11 11 11 11 11 11 11 11 11 11 11 11 19  
19 4 11 11 11 11 11 11 11 11 11 11 11 11 11 11 11 11 11 11 4 19 19 4 11 11 4 19 4 11 11 11 11 11 11 11 4 19 4 11 11 4 19 19 4 11 11 11 11 11 11 11 11 11 11 4 19 19 4 11 11 4 19 4 11 11 11 11 11 11 11 4 19 4 11 11 4 19 19 4 11 11 11 11 11 11 11 11 11 11 11 11 11 11 11 11 11 11 11 19  
19 4 11 11 11 11 11 11 11 11 11 11 11 11 11 11 11 11 11 11 4 19 19 4 11 11 4 19 4 11 11 11 11 11 11 11 4 19 4 11 11 4 19 19 4 11 11 11 11 11 11 11 11 11 11 4 19 19 4 11 11 4 19 4 11 11 11 11 11 11 11 4 19 4 11 11 4 19 19 4 11 11 11 11 11 11 11 11 11 11 11 11 11 11 11 11 11 11 11 19  
19 4 11 11 11 11 11 11 11 11 11 11 11 11 11 11 11 11 11 11 4 19 19 4 11 11 4 19 4 11 11 11 11 11 11 11 4 19 4 11 11 4 19 19 4 11 11 11 11 11 11 11 11 11 11 4 19 19 4 11 11 4 19 4 11 11 11 11 11 11 11 4 19 4 11 11 4 19 19 4 11 11 11 11 11 11 11 11 11 11 11 11 11 11 11 11 11 11 11 19  
19 4 11 11 11 11 11 11 11 11 11 11 11 11 11 11 11 11 11 11 4 19 19 4 11 11 4 19 4 11 11 11 11 11 11 11 4 19 4 11 11 4 19 19 4 11 11 11 11 11 11 11 11 11 11 4 19 19 4 11 11 4 19 4 11 11 11 11 11 11 11 4 19 4 11 11 4 19 19 4 11 11 11 11 11 11 11 11 11 11 11 11 11 11 11 11 11 11 11 19  
19 4 11 11 11 11 11 11 11 11 11 11 11 11 11 11 11 11 11 11 4 19 19 4 11 11 4 19 4 11 11 11 11 11 11 11 4 19 4 11 11 4 19 19 4 11 11 11 11 11 11 11 11 11 11 4 19 19 4 11 11 4 19 4 11 11 11 11 11 11 11 4 19 4 11 11 4 19 19 4 11 11 11 11 11 11 11 11 11 11 11 11 11 11 11 11 11 11 11 19  
19 4 11 11 11 11 11 11 11 11 11 11 11 11 11 11 11 11 11 11 4 19 19 4 11 11 4 19 4 11 11 11 11 11 11 11 4 19 4 11 11 4 19 19 4 11 11 11 11 11 11 11 11 11 11 4 19 19 4 11 11 4 19 4 11 11 11 11 11 11 11 4 19 4 11 11 4 19 19 4 11 11 11 11 11 11 11 11 11 11 11 11 11 11 11 11 11 11 11 19  
19 4 11 11 11 11 11 11 11 11 11 11 11 11 11 11 11 11 11 11 4 19 19 4 11 11 4 19 4 11 11 11 11 11 11 11 4 19 4 11 11 4 19 19 4 11 11 11 11 11 11 11 11 11 11 4 19 19 4 11 11 4 19 4 11 11 11 11 11 11 11 4 19 4 11 11 4 19 19 4 11 11 11 11 11 11 11 11 11 11 11 11 11 11 11 11 11 11 11 19  
19 4 11 11 11 11 11 11 11 11 11 11 11 11 11 11 11 11 11 11 4 19 19 4 11 11 4 19 4 11 11 11 11 11 11 11 4 19 4 11 11 4 19 19 4 11 11 11 11 11 11 11 11 11 11 4 19 19 4 11 11 4 19 4 11 11 11 11 11 11 11 4 19 4 11 11 4 19 19 4 11 11 11 11 11 11 11 11 11 11 11 11 11 11 11 11 11 11 11 19  
19 4 11 11 11 11 11 11 11 11 11 11 11 11 11 11 11 11 11 11 4 19 19 4 11 11 4 19 4 11 11 11 11 11 11 11 4 19 4 11 11 4 19 19 4 11 11 11 11 11 11 11 11 11 11 4 19 19 4 11 11 4 19 4 11 11 11 11 11 11 11 4 19 4 11 11 4 19 19 4 11 11 11 11 11 11 11 11 11 11 11 11 11 11 11 11 11 11 11 19  
19 4 11 11 11 11 11 11 11 11 11 11 11 11 11 11 11 11 11 11 4 19 19 4 11 11 4 19 4 11 11 11 11 11 11 11 4 19 4 11 11 4 19 19 4 11 11 11 11 11 11 11 11 11 11 4 19 19 4 11 11 4 19 4 11 11 11 11 11 11 11 4 19 4 11 11 4 19 19 4 11 11 11 11 11 11 11 11 11 11 11 11 11 11 11 11 11 11 11 19  
19 4 11 11 11 11 11 11 11 11 11 11 11 11 11 11 11 11 11 11 4 19 19 4 11 11 4 19 4 11 11 11 11 11 11 11 4 19 4 11 11 4 19 19 4 11 11 11 11 11 11 11 11 11 11 4 19 19 4 11 11 4 19 4 11 11 11 11 11 11 11 4 19 4 11 11 4 19 19 4 11 11 11 11 11 11 11 11 11 11 11 11 11 11 11 11 11 11 11 19  
19 4 11 11 11 11 11 11 11 11 11 11 11 11 11 11 11 11 11 11 4 19 19 4 11 11 4 19 4 11 11 11 11 11 11 11 4 19 4 11 11 4 19 19 4 11 11 11 11 11 11 11 11 11 11 4 19 19 4 11 11 4 19 4 11 11 11 11 11 11 11 4 19 4 11 11 4 19 19 4 11 11 11 11 11 11 11 11 11 11 11 11 11 11 11 11 11 11 11 19  
19 4 11 11 11 11 11 11 11 11 11 11 11 11 11 11 11 11 11 11 4 19 19 4 11 11 4 19 4 11 11 11 11 11 11 11 4 19 4 11 11 4 19 19 4 11 11 11 11 11 11 11 11 11 11 4 19 19 4 11 11 4 19 4 11 11 11 11 11 11 11 4 19 4 11 11 4 19 19 4 11 11 11 11 11 11 11 11 11 11 11 11 11 11 11 11 11 11 11 19  
19 4 11 11 11 11 11 11 11 11 11 11 11 11 11 11 11 11 11 11 4 19 19 4 11 11 4 19 4 11 11 11 11 11 11 11 4 19 4 11 11 4 19 19 4 11 11 11 11 11 11 11 11 11 11 4 19 19 4 11 11 4 19 4 11 11 11 11 11 11 11 4 19 4 11 11 4 19 19 4 11 11 11 11 11 11 11 11 11 11 11 11 11 11 11 11 11 11 11 19  
19 4 11 11 11 11 11 11 11 11 11 11 11 11 11 11 11 11 11 11 4 19 19 4 11 11 4 19 4 11 11 11 11 11 11 11 4 19 4 11 11 4 19 19 4 11 11 11 11 11 11 11 11 11 11 4 19 19 4 11 11 4 19 4 11 11 11 11 11 11 11 4 19 4 11 11 4 19 19 4 11 11 11 11 11 11 11 11 11 11 11 11 11 11 11 11 11 11 11 19  
19 4 11 11 11 11 11 11 11 11 11 11 11 11 11 11 11 11 11 11 4 19 19 4 11 11 4 19 4 11 11 11 11 11 11 11 4 19 4 11 11 4 19 19 4 11 11 11 11 11 11 11 11 11 11 4 19 19 4 11 11 4 19 4 11 11 11 11 11 11 11 4 19 4 11 11 4 19 19 4 11 11 11 11 11 11 11 11 11 11 11 11 11 11 11 11 11 11 11 19  
19 4 11 11 11 11 11 11 11 11 11 11 11 11 11 11 11 11 11 11 4 19 19 4 11 11 4 19 4 11 11 11 11 11 11 11 4 19 4 11 11 4 19 19 4 11 11 11 11 11 11 11 11 11 11 4 19 19 4 11 11 4 19 4 11 11 11 11 11 11 11 4 19 4 11 11 4 19 19 4 11 11 11 11 11 11 11 11 11 11 11 11 11 11 11 11 11 11 11 19  
19 4 11 11 11 11 11 11 11 11 11 11 11 11 11 11 11 11 11 11 4 19 19 4 11 11 4 19 4 11 11 11 11 11 11 11 4 19 4 11 11 4 19 19 4 11 11 11 11 11 11 11 11 11 11 4 19 19 4 11 11 4 19 4 11 11 11 11 11 11 11 4 19 4 11 11 4 19 19 4 11 11 11 11 11 11 11 11 11 11 11 11 11 11 11 11 11 11 11 19  
19 4 11 11 11 11 11 11 11 11 11 11 11 11 11 11 11 11 11 11 4 19 19 4 11 11 4 19 4 11 11 11 11 11 11 11 4 19 4 11 11 4 19 19 4 11 11 11 11 11 11 11 11 11 11 4 19 19 4 11 11 4 19 4 11 11 11 11 11 11 11 4 19 4 11 11 4 19 19 4 11 11 11 11 11 11 11 11 11 11 11 11 11 11 11 11 11 11 11 19  
19 4 11 11 11 11 11 11 11 11 11 11 11 11 11 11 11 11 11 11 4 19 19 4 11 11 4 19 4 11 11 11 11 11 11 11 4 19 4 11 11 4 19 19 4 11 11 11 11 11 11 11 11 11 11 4 19 19 4 11 11 4 19 4 11 11 11 11 11 11 11 4 19 4 11 11 4 19 19 4 11 11 11 11 11 11 11 11 11 11 11 11 11 11 11 11 11 11 11 19  
19 4 11 11 11 11 11 11 11 11 11 11 11 11 11 11 11 11 11 11 4 19 19 4 11 11 4 19 4 11 11 11 11 11 11 11 4 19 4 11 11 4 19 19 4 11 11 11 11 11 11 11 11 11 11 4 19 19 4 11 11 4 19 4 11 11 11 11 11 11 11 4 19 4 11 11 4 19 19 4 11 11 11 11 11 11 11 11 11 11 11 11 11 11 11 11 11 11 11 19  
19 4 11 11 11 11 11 11 11 11 11 11 11 11 11 11 11 11 11 11 4 19 19 4 11 11 4 19 4 11 11 11 11 11 11 11 4 19 4 11 11 4 19 19 4 11 11 11 11 11 11 11 11 11 11 4 19 19 4 11 11 4 19 4 11 11 11 11 11 11 11 4 19 4 11 11 4 19 19 4 11 11 11 11 11 11 11 11 11 11 11 11 11 11 11 11 11 11 11 19  
19 4 11 11 11 11 11 11 11 11 11 11 11 11 11 11 11 11 11 11 4 19 19 4 11 11 4 19 4 11 11 11 11 11 11 11 4 19 4 11 11 4 19 19 4 11 11 11 11 11 11 11 11 11 11 4 19 19 4 11 11 4 19 4 11 11 11 11 11 11 11 4 19 4 11 11 4 19 19 4 11 11 11 11 11 11 11 11 11 11 11 11 11 11 11 11 11 11 11 19  
19 4 11 11 11 11 11 11 11 11 11 11 11 11 11 11 11 11 11 11 4 19 19 4 11 11 4 19 4 11 11 11 11 11 11 11 4 19 4 11 11 4 19 19 4 11 11 11 11 11 11 11 11 11 11 4 19 19 4 11 11 4 19 4 11 11 11 11 11 11 11 4 19 4 11 11 4 19 19 4 11 11 11 11 11 11 11 11 11 11 11 11 11 11 11 11 11 11 11 19  
19 4 11 11 11 11 11 11 11 11 11 11 11 11 11 11 11 11 11 11 4 19 19 4 11 11 4 19 4 11 11 11 11 11 11 11 4 19 4 11 11 4 19 19 4 11 11 11 11 11 11 11 11 11 11 4 19 19 4 11 11 4 19 4 11 11 11 11 11 11 11 4 19 4 11 11 4 19 19 4 11 11 11 11 11 11 11 11 11 11 11 11 11 11 11 11 11 11 11 19  
19 4 11 11 11 11 11 11 11 11 11 11 11 11 11 11 11 11 11 11 4 19 19 4 11 11 4 19 4 11 11 11 11 11 11 11 4 19 4 11 11 4 19 19 4 11 11 11 11 11 11 11 11 11 11 4 19 19 4 11 11 4 19 4 11 11 11 11 11 11 11 4 19 4 11 11 4 19 19 4 11 11 11 11 11 11 11 11 11 11 11 11 11 11 11 11 11 11 11 19  
19 4 11 11 11 11 11 11 11 11 11 11 11 11 11 11 11 11 11 11 4 19 19 4 11 11 4 19 4 11 11 11 11 11 11 11 4 19 4 11 11 4 19 19 4 11 11 11 11 11 11 11 11 11 11 4 19 19 4 11 11 4 19 4 11 11 11 11 11 11 11 4 19 4 11 11 4 19 19 4 11 11 11 11 11 11 11 11 11 11 11 11 11 11 11 11 11 11 11 19  
19 4 11 11 11 11 11 11 11 11 11 11 11 11 11 11 11 11 11 11 4 19 19 4 11 11 4 19 4 11 11 11 11 11 11 11 4 19 4 11 11 4 19 19 4 11 11 11 11 11 11 11 11 11 11 4 19 19 4 11 11 4 19 4 11 11 11 11 11 11 11 4 19 4 11 11 4 19 19 4 11 11 11 11 11 11 11 11 11 11 11 11 11 11 11 11 11 11 11 19  
19 4 11 11 11 11 11 11 11 11 11 11 11 11 11 11 11 11 11 11 4 19 19 4 11 11 4 19 4 11 11 11 11 11 11 11 4 19 4 11 11 4 19 19 4 11 11 11 11 11 11 11 11 11 11 4 19 19 4 11 11 4 19 4 11 11 11 11 11 11 11 4 19 4 11 11 4 19 19 4 11 11 11 11 11 11 11 11 11 11 11 11 11 11 11 11 11 11 11 19  
19 4 11 11 11 11 11 11 11 11 11 11 11 11 11 11 11 11 11 11 4 19 19 4 11 11 4 19 4 11 11 11 11 11 11 11 4 19 4 11 11 4 19 19 4 11 11 11 11 11 11 11 11 11 11 4 19 19 4 11 11 4 19 4 11 11 11 11 11 11 11 4 19 4 11 11 4 19 19 4 11 11 11 11 11 11 11 11 11 11 11 11 11 11 11 11 11 11 11 19  
19 4 11 11 11 11 11 11 11 11 11 11 11 11 11 11 11 11 11 11 4 19 19 4 11 11 4 19 4 11 11 11 11 11 11 11 4 19 4 11 11 4 19 19 4 11 11 11 11 11 11 11 11 11 11 4 19 19 4 11 11 4 19 4 11 11 11 11 11 11 11 4 19 4 11 11 4 19 19 4 11 11 11 11 11 11 11 11 11 11 11 11 11 11 11 11 11 11 11 19  
19 4 11 11 11 11 11 11 11 11 11 11 11 11 11 11 11 11 11 11 4 19 19 4 11 11 4 19 4 11 11 11 11 11 11 11 4 19 4 11 11 4 19 19 4 11 11 11 11 11 11 11 11 11 11 4 19 19 4 11 11 4 19 4 11 11 11 11 11 11 11 4 19 4 11 11 4 19 19 4 11 11 11 11 11 11 11 11 11 11 11 11 11 11 11 11 11 11 11 19  
19 4 11 11 11 11 11 11 11 11 11 11 11 11 11 11 11 11 11 11 4 19 19 4 11 11 4 19 4 11 19 19 19 19 19 11 4 19 4 11 11 4 19 19 4 11 11 11 11 11 11 11 11 11 11 4 19 19 4 11 11 4 19 4 11 19 5 5 5 19 11 4 19 4 11 11 4 19 19 4 11 11 11 11 11 11 11 11 11 11 11 11 11 11 11 11 11 11 11 19  
19 4 11 11 11 11 11 11 11 11 11 11 11 11 11 11 11 11 11 11 4 19 19 4 11 11 4 19 4 11 19 5 5 5 19 11 4 19 4 11 11 4 19 19 4 11 11 11 11 11 11 11 11 11 11 4 19 19 4 11 11 4 19 4 11 19 5 5 5 19 11 4 19 4 11 11 4 19 19 4 11 11 11 11 11 11 11 11 11 11 11 11 11 11 11 11 11 11 11 19  
19 4 11 11 11 11 11 11 11 11 11 11 11 11 11 11 11 11 11 11 4 19 19 4 11 11 4 19 4 11 19 5 5 5 19 11 4 19 4 11 11 4 19 19 4 11 11 11 11 11 11 11 11 11 11 4 19 19 4 11 11 4 19 4 11 19 19 19 19 19 11 4 19 4 11 11 4 19 19 4 11 11 11 11 11 11 11 11 11 11 11 11 11 11 11 11 11 11 11 19  
19 4 11 11 11 11 11 11 11 11 11 11 11 11 11 11 11 11 11 11 4 19 19 4 11 11 4 19 4 11 11 11 11 11 11 11 4 19 4 11 11 4 19 19 4 11 11 11 11 11 11 11 11 11 11 4 19 19 4 11 11 4 19 4 11 11 11 11 11 11 11 4 19 4 11 11 4 19 19 4 11 11 11 11 11 11 11 11 11 11 11 11 11 11 11 11 11 11 11 19  
19 4 11 11 11 11 11 11 11 11 11 11 11 11 11 11 11 11 11 11 4 19 19 4 11 11 4 19 4 11 11 11 11 11 11 11 4 19 4 11 11 4 19 19 4 11 11 11 11 11 11 11 11 11 11 4 19 19 4 11 11 4 19 4 11 11 11 11 11 11 11 4 19 4 11 11 4 19 19 4 11 11 11 11 11 11 11 11 11 11 11 11 11 11 11 11 11 11 11 19  
19 4 11 11 11 11 11 11 11 11 11 11 11 11 11 11 11 11 11 11 4 19 19 4 11 11 4 19 4 11 11 11 11 11 11 11 4 19 4 11 11 4 19 19 4 11 11 11 11 11 11 11 11 11 11 4 19 19 4 11 11 4 19 4 11 11 11 11 11 11 11 4 19 4 11 11 4 19 19 4 11 11 11 11 11 11 11 11 11 11 11 11 11 11 11 11 11 11 11 19  
19 4 11 11 11 11 11 11 11 11 11 11 11 11 11 11 11 11 11 11 4 19 19 4 11 11 4 19 4 11 11 11 11 11 11 11 4 19 4 11 11 4 19 19 4 11 11 11 11 11 11 11 11 11 11 4 19 19 4 11 11 4 19 4 11 11 11 11 11 11 11 4 19 4 11 11 4 19 19 4 11 11 11 11 11 11 11 11 11 11 11 11 11 11 11 11 11 11 11 19  
19 4 11 11 11 11 11 11 11 11 11 11 11 11 11 11 11 11 11 11 4 19 19 4 11 11 4 19 4 11 11 11 11 11 11 11 4 19 4 11 11 4 19 19 4 11 11 11 11 11 11 11 11 11 11 4 19 19 4 11 11 4 19 4 11 11 11 11 11 11 11 4 19 4 11 11 4 19 19 4 11 11 11 11 11 11 11 11 11 11 11 11 11 11 11 11 11 11 11 19  
19 4 11 11 11 11 11 11 11 11 11 11 11 11 11 11 11 11 11 11 4 19 19 4 11 11 4 19 4 11 11 11 11 11 11 11 4 19 4 11 11 4 19 19 4 11 11 11 11 11 11 11 11 11 11 4 19 19 4 11 11 4 19 4 11 11 11 11 11 11 11 4 19 4 11 11 4 19 19 4 11 11 11 11 11 11 11 11 11 11 11 11 11 11 11 11 11 11 11 19  
19 4 11 11 11 11 11 11 11 11 11 11 11 11 11 11 11 11 11 11 4 19 19 4 11 11 4 19 4 11 11 11 11 11 11 11 4 19 4 11 11 4 19 19 4 11 11 11 11 11 11 11 11 11 11 4 19 19 4 11 11 4 19 4 11 11 11 11 11 11 11 4 19 4 11 11 4 19 19 4 11 11 11 11 11 11 11 11 11 11 11 11 11 11 11 11 11 11 11 19  
19 4 11 11 11 11 11 11 11 11 11 11 11 11 11 11 11 11 11 11 4 19 19 4 11 11 4 19 4 11 11 11 11 11 11 11 4 19 4 11 11 4 19 19 4 11 11 11 11 11 11 11 11 11 11 4 19 19 4 11 11 4 19 4 11 11 11 11 11 11 11 4 19 4 11 11 4 19 19 4 11 11 11 11 11 11 11 11 11 11 11 11 11 11 11 11 11 11 11 19  
19 4 11 11 11 11 11 11 11 11 11 11 11 11 11 11 11 11 11 11 4 19 19 4 11 11 4 19 4 11 11 11 11 11 11 11 4 19 4 11 11 4 19 19 4 11 11 11 11 11 11 11 11 11 11 4 19 19 4 11 11 4 19 4 11 11 11 11 11 11 11 4 19 4 11 11 4 19 19 4 11 11 11 11 11 11 11 11 11 11 11 11 11 11 11 11 11 11 11 19  
19 4 11 11 11 11 11 11 11 11 11 11 11 11 11 11 11 11 11 11 4 19 19 4 11 11 4 19 4 11 11 11 11 11 11 11 4 19 4 11 11 4 19 19 4 11 11 11 11 11 11 11 11 11 11 4 19 19 4 11 11 4 19 4 11 11 11 11 11 11 11 4 19 4 11 11 4 19 19 4 11 11 11 11 11 11 11 11 11 11 11 11 11 11 11 11 11 11 11 19  
19 4 11 11 11 11 11 11 11 11 11 11 11 11 11 11 11 11 11 11 4 19 19 4 11 11 4 19 4 11 11 11 11 11 11 11 4 19 4 11 11 4 19 19 4 11 11 11 11 11 11 11 11 11 11 4 19 19 4 11 11 4 19 4 11 11 11 11 11 11 11 4 19 4 11 11 4 19 19 4 11 11 11 11 11 11 11 11 11 11 11 11 11 11 11 11 11 11 11 19  
19 4 11 11 11 11 11 11 11 11 11 11 11 11 11 11 11 11 11 11 4 19 19 4 11 11 4 19 4 11 11 11 11 11 11 11 4 19 4 11 11 4 19 19 4 11 11 11 11 11 11 11 11 11 11 4 19 19 4 11 11 4 19 4 11 11 11 11 11 11 11 4 19 4 11 11 4 19 19 4 11 11 11 11 11 11 11 11 11 11 11 11 11 11 11 11 11 11 11 19  
19 4 11 11 11 11 11 11 11 11 11 11 11 11 11 11 11 11 11 11 4 19 19 4 11 11 4 19 4 11 11 11 11 11 11 11 4 19 4 11 11 4 19 19 4 11 11 11 11 11 11 11 11 11 11 4 19 19 4 11 11 4 19 4 11 11 11 11 11 11 11 4 19 4 11 11 4 19 19 4 11 11 11 11 11 11 11 11 11 11 11 11 11 11 11 11 11 11 11 19  
19 4 11 11 11 11 11 11 11 11 11 11 11 11 11 11 11 11 11 11 4 19 19 4 11 11 4 19 4 11 11 11 11 11 11 11 4 19 4 11 11 4 19 19 4 11 11 11 11 11 11 11 11 11 11 4 19 19 4 11 11 4 19 4 11 11 11 11 11 11 11 4 19 4 11 11 4 19 19 4 11 11 11 11 11 11 11 11 11 11 11 11 11 11 11 11 11 11 11 19  
19 4 11 11 11 11 11 11 11 11 11 11 11 11 11 11 11 11 11 11 4 19 19 4 11 11 4 19 4 11 11 11 11 11 11 11 4 19 4 11 11 4 19 19 4 11 11 11 11 11 11 11 11 11 11 4 19 19 4 11 11 4 19 4 11 11 11 11 11 11 11 4 19 4 11 11 4 19 19 4 11 11 11 11 11 11 11 11 11 11 11 11 11 11 11 11 11 11 11 19  
19 4 11 11 11 11 11 11 11 11 11 11 11 11 11 11 11 11 11 11 4 19 19 4 11 11 4 19 4 11 11 11 11 11 11 11 4 19 4 11 11 4 19 19 4 11 11 11 11 11 11 11 11 11 11 4 19 19 4 11 11 4 19 4 11 11 11 11 11 11 11 4 19 4 11 11 4 19 19 4 11 11 11 11 11 11 11 11 11 11 11 11 11 11 11 11 11 11 11 19  
19 4 11 11 11 11 11 11 11 11 11 11 11 11 11 11 11 11 11 11 4 19 19 4 11 11 4 19 4 11 11 11 11 11 11 11 4 19 4 11 11 4 19 19 4 11 11 11 11 11 11 11 11 11 11 4 19 19 4 11 11 4 19 4 11 11 11 11 11 11 11 4 19 4 11 11 4 19 19 4 11 11 11 11 11 11 11 11 11 11 11 11 11 11 11 11 11 11 11 19  
19 4 11 11 11 11 11 11 11 11 11 11 11 11 11 11 11 11 11 11 4 19 19 4 11 11 4 19 4 11 11 11 11 11 11 11 4 19 4 11 11 4 19 19 4 11 11 11 11 11 11 11 11 11 11 4 19 19 4 11 11 4 19 4 11 11 11 11 11 11 11 4 19 4 11 11 4 19 19 4 11 11 11 11 11 11 11 11 11 11 11 11 11 11 11 11 11 11 11 19  
19 4 11 11 11 11 11 11 11 11 11 11 11 11 11 11 11 11 11 11 4 19 19 4 11 11 4 19 4 11 11 11 11 11 11 11 4 19 4 11 11 4 19 19 4 11 11 11 11 11 11 11 11 11 11 4 19 19 4 11 11 4 19 4 11 11 11 11 11 11 11 4 19 4 11 11 4 19 19 4 11 11 11 11 11 11 11 11 11 11 11 11 11 11 11 11 11 11 11 19  
19 4 11 11 11 11 11 11 11 11 11 11 11 11 11 11 11 11 11 11 4 19 19 4 11 11 4 19 4 11 11 11 11 11 11 11 4 19 4 11 11 4 19 19 4 11 11 11 11 11 11 11 11 11 11 4 19 19 4 11 11 4 19 4 11 11 11 11 11 11 11 4 19 4 11 11 4 19 19 4 11 11 11 11 11 11 11 11 11 11 11 11 11 11 11 11 11 11 11 19  
19 4 11 11 11 11 11 11 11 11 11 11 11 11 11 11 11 11 11 11 4 19 19 4 11 11 4 19 4 11 11 11 11 11 11 11 4 19 4 11 11 4 19 19 4 11 11 11 11 11 11 11 11 11 11 4 19 19 4 11 11 4 19 4 11 11 11 11 11 11 11 4 19 4 11 11 4 19 19 4 11 11 11 11 11 11 11 11 11 11 11 11 11 11 11 11 11 11 11 19  
19 4 11 11 11 11 11 11 11 11 11 11 11 11 11 11 11 11 11 11 4 19 19 4 11 11 4 19 4 11 11 11 11 11 11 11 4 19 4 11 11 4 19 19 4 11 11 11 11 11 11 11 11 11 11 4 19 19 4 11 11 4 19 4 11 11 11 11 11 11 11 4 19 4 11 11 4 19 19 4 11 11 11 11 11 11 11 11 11 11 11 11 11 11 11 11 11 11 11 19  
19 4 11 11 11 11 11 11 11 11 11 11 11 11 11 11 11 11 11 11 4 19 19 4 11 11 4 19 4 11 11 11 11 11 11 11 4 19 4 11 11 4 19 19 4 11 11 11 11 11 11 11 11 11 11 4 19 19 4 11 11 4 19 4 11 11 11 11 11 11 11 4 19 4 11 11 4 19 19 4 11 11 11 11 11 11 11 11 11 11 11 11 11 11 11 11 11 11 11 19  
19 4 11 11 11 11 11 11 11 11 11 11 11 11 11 11 11 11 11 11 4 19 19 4 11 11 4 19 4 11 11 11 11 11 11 11 4 19 4 11 11 4 19 19 4 11 11 11 11 11 11 11 11 11 11 4 19 19 4 11 11 4 19 4 11 11 11 11 11 11 11 4 19 4 11 11 4 19 19 4 11 11 11 11 11 11 11 11 11 11 11 11 11 11 11 11 11 11 11 19  
19 4 11 11 11 11 11 11 11 11 11 11 11 11 11 11 11 11 11 11 4 19 19 4 11 11 4 19 4 11 11 11 11 11 11 11 4 19 4 11 11 4 19 19 4 11 11 11 11 11 11 11 11 11 11 4 19 19 4 11 11 4 19 4 11 11 11 11 11 11 11 4 19 4 11 11 4 19 19 4 11 11 11 11 11 11 11 11 11 11 11 11 11 11 11 11 11 11 11 19  
19 4 11 11 11 11 11 11 11 11 11 11 11 11 11 11 11 11 11 11 4 19 19 4 11 11 4 19 4 11 11 11 11 11 11 11 4 19 4 11 11 4 19 19 4 11 11 11 11 11 11 11 11 11 11 4 19 19 4 11 11 4 19 4 11 11 11 11 11 11 11 4 19 4 11 11 4 19 19 4 11 11 11 11 11 11 11 11 11 11 11 11 11 11 11 11 11 11 11 19  
19 4 11 11 11 11 11 11 11 11 11 11 11 11 11 11 11 11 11 11 4 19 19 4 11 11 4 19 4 11 11 11 11 11 11 11 4 19 4 11 11 4 19 19 4 11 11 11 11 11 11 11 11 11 11 4 19 19 4 11 11 4 19 4 11 11 11 11 11 11 11 4 19 4 11 11 4 19 19 4 11 11 11 11 11 11 11 11 11 11 11 11 11 11 11 11 11 11 11 19  
19 4 11 11 11 11 11 11 11 11 11 11 11 11 11 11 11 11 11 11 4 19 19 4 11 11 4 19 4 11 11 11 11 11 11 11 4 19 4 11 11 4 19 19 4 11 11 11 11 11 11 11 11 11 11 4 19 19 4 11 11 4 19 4 11 11 11 11 11 11 11 4 19 4 11 11 4 19 19 4 11 11 11 11 11 11 11 11 11 11 11 11 11 11 11 11 11 11 11 19  
19 4 11 11 11 11 11 11 11 11 11 11 11 11 11 11 11 11 11 11 4 19 19 4 11 11 4 19 4 11 11 11 11 11 11 11 4 19 4 11 11 4 19 19 4 11 11 11 11 11 11 11 11 11 11 4 19 19 4 11 11 4 19 4 11 11 11 11 11 11 11 4 19 4 11 11 4 19 19 4 11 11 11 11 11 11 11 11 11 11 11 11 11 11 11 11 11 11 11 19  
19 4 11 11 11 11 11 11 11 11 11 11 11 11 11 11 11 11 11 11 4 19 19 4 11 11 4 19 4 11 11 11 11 11 11 11 4 19 4 11 11 4 19 19 4 11 11 11 11 11 11 11 11 11 11 4 19 19 4 11 11 4 19 4 11 11 11 11 11 11 11 4 19 4 11 11 4 19 19 4 11 11 11 11 11 11 11 11 11 11 11 11 11 11 11 11 11 11 11 19  
19 4 11 11 11 11 11 11 11 11 11 11 11 11 11 11 11 11 11 11 4 19 19 4 11 11 4 19 4 11 11 11 11 11 11 11 4 19 4 11 11 4 19 19 4 11 11 11 11 11 11 11 11 11 11 4 19 19 4 11 11 4 19 4 11 11 11 11 11 11 11 4 19 4 11 11 4 19 19 4 11 11 11 11 11 11 11 11 11 11 11 11 11 11 11 11 11 11 11 19  
19 4 11 11 11 11 11 11 11 11 11 11 11 11 11 11 11 11 11 11 4 19 19 4 11 11 4 19 4 11 11 11 11 11 11 11 4 19 4 11 11 4 19 19 4 11 11 11 11 11 11 11 11 11 11 4 19 19 4 11 11 4 19 4 11 11 11 11 11 11 11 4 19 4 11 11 4 19 19 4 11 11 11 11 11 11 11 11 11 11 11 11 11 11 11 11 11 11 11 19  
19 4 11 11 11 11 11 11 11 11 11 11 11 11 11 11 11 11 11 11 4 19 19 4 11 11 4 19 4 11 11 11 11 11 11 11 4 19 4 11 11 4 19 19 4 11 11 11 11 11 11 11 11 11 11 4 19 19 4 11 11 4 19 4 11 11 11 11 11 11 11 4 19 4 11 11 4 19 19 4 11 11 11 11 11 11 11 11 11 11 11 11 11 11 11 11 11 11 11 19  
19 4 11 11 11 11 11 11 11 11 11 11 11 11 11 11 11 11 11 11 4 19 19 4 11 11 4 19 4 11 11 11 11 11 11 11 4 19 4 11 11 4 19 19 4 11 11 11 11 11 11 11 11 11 11 4 19 19 4 11 11 4 19 4 11 11 11 11 11 11 11 4 19 4 11 11 4 19 19 4 11 11 11 11 11 11 11 11 11 11 11 11 11 11 11 11 11 11 11 19  
19 4 11 11 11 11 11 11 11 11 11 11 11 11 11 11 11 11 11 11 4 19 19 4 11 11 4 19 4 11 11 11 11 11 11 11 4 19 4 11 11 4 19 19 4 11 11 11 11 11 11 11 11 11 11 4 19 19 4 11 11 4 19 4 11 11 11 11 11 11 11 4 19 4 11 11 4 19 19 4 11 11 11 11 11 11 11 11 11 11 11 11 11 11 11 11 11 11 11 19  
19 4 11 11 11 11 11 11 11 11 11 11 11 11 11 11 11 11 11 11 4 19 19 4 11 11 4 19 4 11 11 11 11 11 11 11 4 19 4 11 11 4 19 19 4 11 11 11 11 11 11 11 11 11 11 4 19 19 4 11 11 4 19 4 11 11 11 11 11 11 11 4 19 4 11 11 4 19 19 4 11 11 11 11 11 11 11 11 11 11 11 11 11 11 11 11 11 11 11 19  
19 4 11 11 11 11 11 11 11 11 11 11 11 11 11 11 11 11 11 11 4 19 19 4 11 11 4 19 4 11 11 11 11 11 11 11 4 19 4 11 11 4 19 19 4 11 11 11 11 11 11 11 11 11 11 4 19 19 4 11 11 4 4 4 11 11 11 11 11 11 11 4 4 4 11 11 4 19 19 4 11 11 11 11 11 11 11 11 11 11 11 11 11 11 11 11 11 11 11 19  
19 4 11 11 11 11 11 11 11 11 11 11 11 11 11 11 11 11 11 11 4 19 19 4 11 11 4 19 4 11 11 11 11 11 11 11 4 19 4 11 11 4 19 19 4 11 11 11 11 11 11 11 11 11 11 4 19 19 4 11 11 11 11 11 11 11 11 11 11 11 11 11 11 11 11 11 4 19 19 4 11 11 11 11 11 11 11 11 11 11 11 11 11 11 11 11 11 11 11 19  
19 4 11 11 11 11 11 11 11 11 11 11 11 11 11 11 11 11 11 11 4 19 19 4 11 11 4 19 4 11 11 11 11 11 11 11 4 19 4 11 11 4 19 19 4 11 11 11 11 11 11 11 11 11 11 4 19 19 4 11 11 11 11 11 11 11 11 11 11 11 11 11 11 11 11 11 4 19 19 4 11 11 11 11 11 11 11 11 11 11 11 11 11 11 11 11 11 11 11 19  
19 4 11 11 11 11 11 11 11 11 11 11 11 11 11 11 11 11 11 11 4 19 19 4 11 11 4 19 4 11 11 11 11 11 11 11 4 19 4 11 11 4 19 19 4 11 11 11 11 11 11 11 11 11 11 4 19 19 4 4 4 4 4 4 4 4 4 4 4 4 4 4 4 4 4 4 4 19 19 4 11 11 11 11 11 11 11 11 11 11 11 11 11 11 11 11 11 11 11 19  
19 4 11 11 11 11 11 11 11 11 11 11 11 11 11 11 11 11 11 11 4 19 19 4 11 11 4 19 4 4 4 4 4 4 4 4 4 19 4 11 11 4 19 19 4 11 11 11 11 11 11 11 11 11 11 4 19 19 19 19 19 19 19 19 19 19 19 19 19 19 19 19 19 19 19 19 19 19 19 4 11 11 11 11 11 11 11 11 11 11 11 11 11 11 11 11 11 11 11 19  
19 4 11 11 11 11 11 11 11 11 11 11 11 11 11 11 11 11 11 11 4 19 19 4 11 11 4 19 19 19 19 19 19 19 19 19 19 19 4 11 11 4 19 19 4 11 11 11 11 11 11 11 11 11 11 4 19 19 19 19 19 19 19 19 19 19 19 19 19 19 19 19 19 19 19 19 19 19 19 4 11 11 11 11 11 11 11 11 11 11 11 11 11 11 11 11 11 11 11 19  
19 4 11 11 11 11 11 11 11 11 11 11 11 11 11 11 11 11 11 11 4 4 4 4 11 11 4 4 4 4 4 4 4 4 4 4 4 4 4 11 11 4 4 4 4 11 11 11 11 11 11 11 11 11 11 4 4 4 4 4 4 4 4 4 4 4 4 4 4 4 4 4 4 4 4 4 4 4 4 4 11 11 11 11 11 11 11 11 11 11 11 11 11 11 11 11 11 11 11 19  
19 4 11 11 11 11 11 11 11 11 11 11 11 11 11 11 11 11 11 11 11 11 11 11 11 11 11 11 11 11 11 11 11 11 11 11 11 11 11 11 11 11 11 11 11 11 11 11 11 11 11 11 11 11 11 11 11 11 11 11 11 11 11 11 11 11 11 11 11 11 11 11 11 11 11 11 11 11 11 11 11 11 11 11 11 11 11 11 11 11 11 11 11 11 11 11 11 11 11 19  
19 4 11 11 11 11 11 11 11 11 11 11 11 11 11 11 11 11 11 11 11 11 11 11 11 11 11 11 11 11 11 11 11 11 11 11 11 11 11 11 11 11 11 11 11 11 11 11 11 11 11 11 11 11 11 11 11 11 11 11 11 11 11 11 11 11 11 11 11 11 11 11 11 11 11 11 11 11 11 11 11 11 11 11 11 11 11 11 11 11 11 11 11 11 11 11 11 11 11 19  
19 4 11 11 11 11 11 11 11 11 11 11 11 11 11 11 11 11 11 11 11 11 11 11 11 11 11 11 11 11 11 11 11 11 11 11 11 11 11 11 11 11 11 11 11 11 11 11 11 11 11 11 11 11 11 11 11 11 11 11 11 11 11 11 11 11 11 11 11 11 11 11 11 11 11 11 11 11 11 11 11 11 11 11 11 11 11 11 11 11 11 11 11 11 11 11 11 11 11 19  
19 4 11 11 11 11 11 11 11 11 11 11 11 11 11 11 11 11 11 11 11 11 11 11 11 11 11 11 11 11 11 11 11 11 11 11 11 11 11 11 11 11 11 11 11 11 11 11 11 11 11 11 11 11 11 11 11 11 11 11 11 11 11 11 11 11 11 11 11 11 11 11 11 11 11 11 11 11 11 11 11 11 11 11 11 11 11 11 11 11 11 11 11 11 11 11 11 11 11 19  
19 4 4 4 4 4 4 4 4 4 4 4 4 4 4 4 4 4 4 4 4 4 4 4 4 4 4 4 4 4 4 4 4 4 4 4 4 4 4 4 4 4 4 4 4 4 4 4 4 4 4 4 4 4 4 4 4 4 4 4 4 4 4 4 4 4 4 4 4 4 4 4 4 4 4 4 4 4 4 4 4 4 4 4 4 4 4 4 4 4 4 4 4 4 4 4 4 4 4 19  
19 19 19 19 19 19 19 19 19 19 19 19 19 19 19 19 19 19 19 19 19 19 19 19 19 19 19 19 19 19 19 19 19 19 19 19 19 19 19 19 19 19 19 19 19 19 19 19 19 19 19 19 19 19 19 19 19 19 19 19 19 19 19 19 19 19 19 19 19 19 19 19 19 19 19 19 19 19 19 19 19 19 19 19 19 19 19 19 19 19 19 19 19 19 19 19 19 19 19 19  